##########
#...##.#.#
#.#..#...#
#S##...#.#
#.#..#...#
#...##.#.#
#.#..#.#.#
#.##...#.#
#..E.#...#
##########
